15 15
***************
*P*     T    T*
*D  K ***     *
*WWWWWWWWWWW S*
*T      ***** *
* *********G***
*  *T  ****D***
*  * * **** ***
*  * *      ***
*  * *      ***
*    * ** * ***
*  * * **T*****
*  * * *****F *
*T * *     T*P*
***************

START,3,13,
DOOR,RED,2,1,
DOOR,TOKEN,6,11,7,
TELE,1,1,13,13,
TELE,13,13,1,1,
ENEMY,STRAIGHT,RIGHT,1,3,
ENEMY,STRAIGHT,RIGHT,4,2,
ENEMY,STRAIGHT,UP,10,11,
ENEMY,STRAIGHT,DOWN,7,4,
KEY,RED,6,2,
 